**T____Z
**(....)
**(....)
**(....)
**(....x__________Z
**(00000..........)
**(...............)
**L---------X.....)
************(11111)
************(.....)
************L-----J