***T__Z*****T__Z
***(..)*****(..)
***(00)*****(..)
***(..)*****(..)
***(..x_____x..)
***(......1....)
***(......1....)
***L-----------J