***T________________________Z
***(...x000x...x111x...x...x)
***(.x000x...x111x...x...x22)
***(000x...x111x...x...x222x)
***(.x...x111x...x...x222x..)
***(...x111x...x...x222x...x)
***(.x111x...x...x222x...x..)
***(111x...x...x222x...x...x)
***(.x...x...x222x...x...x..)
***L------------------------J