**T_________Z*****T_________Z
**(.........x_____x.........)
**(.........................)
**(...x.x...000......x..x111)
**(.........K-----X.........)
**L---------J*****L---------J